对话场景词汇：
A：Office Hours 办公时间—Student & Professor
论文
论文：
office hour	[ˈauə]n.办公时间
term paper	[ˈpeipə]n.学期论文.
essay	n.作文，散文
thesis statement 论文陈述
proposed topics	推荐的论文选题
selecting topic 选择性题目
scope	n.范围
wander off topic	[ɔ(:)f] [ˈtɔpik]v.跑题.
available	可利用的
collection 藏书
research data 调查数据
research project 调查项目
preliminary outline	初步提纲
final outline 最终提纲
first draft	[fə:st] [drɑ:ft]n.初稿
draft version	草拟版本
look over a draft version	[ˈəuvə] [ə] [drɑ:ft] [ˈvə:ʃən]v. 检查草拟版本
comment	n.vt.评论
make comment	评论
rewrite	v.重写
revise	v.校正
edited version	修订版
final copy	[ˈkɔpi]最后打印版
hand in the final copy	[in] [ðə] [ˈfainəl] [ˈkɔpi]v. 提
交最后打印版
final format	最终格式
catalog 目录
design plan	[plæn]n.设计方案.
draw up 得出结论
reference section	[ˈsekʃ(ə)n]n.参考部分
fixed date 固定日期
submission	提交
issue 发行
疑难解答
考试专业疑难解答：
考试：
term exam	[tə:m] [igˈzæm]n.期中考试
grade	n.成绩
revision	复习
fail 不及格
re-take 重修
选课与作业(见选课和注册办公室)：
elective 选修
selective 选修课
bird course 轻松的课
hard course 困难的课程
intermediate level	中级水平
summer session 暑期课程
seminar	研讨会
workshop 小型研讨会
presentation	课堂展示
slide	幻灯片
register 注册
sign up 注册
sign up for a noncredit course	注册
permission to register	允许注册
due	adj.截止
deadline	n.截止日期
group project	[ˈ prɔdʒekt]n.团队项目
project 作业
assignment	n.作业
quite a heavy load 课业负担沉重
学分与学位：
credit	n.学分
credit is awarded 学分奖励
diploma	证书
bachelor’s degree 学士学位
迟到或缺课：
attendance	出勤
misse somebody’s lecture 缺课
fill me in something 给我补课
extension	n.延期
疑难解答：
bulletin board	公告板
school bulletin 学校公告栏
community center 社区活动中心
be weak in 薄弱
rushing against the clock 忙碌
run into problems 遇到困难
dilemma	n. 两难
transfer 转系转专业
tough decision 艰难的抉择
consult	咨询
enquiry	询问
approach 方法途径
techniques and skills 技巧
s approval	导师许可
letters of recommendation	推荐信
rigorous	adj. 严格的
eligible	adj. 合格的
previous experience	事前经验
take the prerequisite	满足先决条件
submit	提交
sheet 单子
signature 签字
soft copy 邮件发送
check back 核查记录
formal training 正式培训
license 执照，许可
申请
申请与志愿：
volunteer	n.志愿者
requirement	要求
admission	许可
campus	n 校园
semester	n.学期（半年）
[英式 term;术语]
fellowship	[ˈfeləuʃip]n.奖学金
选课
选课(见选课作业和注册办公室)：
credit course ['sɪəriː z 学分课程
required writing course 必修写作课
optional class	选修课
preparatory course	[kɔ:s]n.预备课程：
introduction course	/ [ˌintrəˈdʌkʃən] [kɔ:s].n. 导论课程
foundation course	[kɔ:s]n.基础课程
intermediate course	[kɔ:s]n.中级课程
advanced course	[kɔ:s]n.高级课程
B：Service Encounter 服务咨询-- Student & Officer
Library:图书馆
librarian	n.图书管理员
library	[ˈlaibrəri]n.图书馆间
video library	[ˈlaibrəri]n.录像图书馆
in the basement	[ðə, ði:] [ˈbeismənt]n.地下室
reference room n.阅览室
the reference stacks	[ˈrefərəns] [stæks]n.书库
the front desk	[frʌnt] [desk]n.前台
loan	v.n.借
loan counter	[ˈkauntə] n.借书处
loan period	[ˈpiəriəd] n.借书期限
return	v.还
renew	v.更新，续
reserve	vt.预留/n.储备
photocopier	n.影印机
fine	vt.罚款/n.罚金
charge	=fee[fi:]n.费用
academics	a.学术
journal	n.期刊
literature review	[riˈvju:]n.文献评论
newspaper reviews	[riˈvju:z] n.报纸评论
contemporary reviews	[riˈvju:z]n.当代评论
paperback n.平装本
electronic	adj.电子版的
the rare books	[reə] [buks]珍藏本书
gloves	手套
front cover 书的封面
index	n.索引
literature guide n.导读
reference guide	[gaid]n.参考指南
abstract	vt.摘要
title	n.标题
screen	n.电脑屏幕
database	n.数据库
published and unpublished data	[ənd] [ˏʌnˋpʌblɪʃt]
[ˈdeitə]n.出版未出版数据库
student orientation	[ˌɔ:riənˈteiʃən]n.情况介绍（针
对大学新生）
precaution	n. 预防
Bookstore：书店
merchandises	n.商品
store credit	[ˈkredit] n.商店退款；赊账购物
purchase	=buy [bai] vt.买
retreat	n.退书
policy	n.规定
full refund	[riˈfʌnd, ˈri:fʌnd]n.退款
Cafeteria：食堂
restaurant	/dining room[ˈdaɪnɪŋ] [ru:m]n.餐厅
organic food	[fu:d]n.有机食物
deep fried food	[fraid] [fu:d]n.油炸食物
waiter	n.男服务员
waitress	n.女服务员
snack	n.小吃，快餐
salad	n.沙拉
Registrar’s Office：注册办公室
注册(见选课和考试选课作业)：
dean	n.院长；系主任
department chair	[tʃɛə]
chairperson	n.系主任
enroll in 注册
course	n.课程
basic course	[kɔ:s]n.基础课程
foundational classe	[ˈklæsik] 基础课程
introductory course	[kɔ:s]n. 基础入门课程
the intermediate level course	[ˌintəˈmi:diət] [ˈlevəl]
[kɔ:s]n.中级水平
field work	/research [riˈsə:tʃ]n.实地研究
academic record	[ˈrekɔ:d, riˈkɔ:d]n. 学业成绩
grade point average 平均绩点
credit	n.学分
expense n.花费
tuition	n.学费
scholarship	n. 奖学金
financial aid 助学金
graduation form	[fɔ:m]n.毕业表格.
graduation requirements [ˌgrædʒuˈei ʃ ə n]
[riˈkwaiəmənts]要求
permission	n.允许，许可
verify	vt. 证实
mailing address	n.邮寄地址
faculty advisor：指导老师
生活指导
facilities manager：后勤经理
language lab manager 语言实验室经理
administrating office 行政办公楼
hall	n.大厅
laboratory	n.实验室
dorm	/dormitory [ˈdɔ:mitəri]n.宿舍
auditorium	n.礼堂，会堂
chorus	=choir[ˈkwaiə]n.合唱队
concert	n.音乐会
rehearsal	n.排练，预演
construction	n.建筑施工
request	vt.／n.请求
reschedule	vt.重新安排时间表
summit	n.提交
application	n. 申请
feedback	n.反馈
video	n.视频；录像
Counseling Center：咨询中心
银行和工资
counselor	n. 咨询员
Department Secretary:部门秘书
bank account	n.银行存款/账户
bill	n. 账单
cash	n. 现金
credit card	n.信用卡
deposits	n.存款
paycheck	n. 薪水
payroll	n.工资单；薪水册
salary	=income [ˈinkʌm]n. 工资
fax	n.传真
form	n.表格
table	n.表格
chart	n.图表
Career Services Office:就业服务办公室
实习与打工：
career	n.职业
career advisory service 职业咨询服务
freshman	n.大一新生
sophomore	n.大二
junior	n.大三
seniors	n.大四学生
graduate	vi. 毕业 n.毕业生
interview	n.面试
resume	n.简历
recommend letter	[ˈletə]n.推荐信
employee	n.雇员
employer	n.雇主
intern n. 实习生
alumni	n. 男校友
recruit	vt.招聘
website	n.网站
career	/job fair[dʒɑb fɛr]n.招聘会
wear a suit	[ei, ə, æn, ən] [su:t, sju:t]n.正装
firm	=company [ˈkʌmpəni] =corporation [ˌkɔ:pəˈ reiʃən]n.公司
advancement	=promotion [prəˈməuʃən]n.晋升
Campus Activities.校园活动
校内活动：
off campus 校外
commute	v. 通勤
campus activities. 校园活动
announcement	n.公告；通告
poster	n.海报
flyers	n.传单
social	a.社交
laundry	n. 洗衣房
gym card	[kɑ:d]n.健身卡
request	vt.／n. 请求
appointment	预约，约会
dentist	牙医
Administrating Office 行政办公楼
department 院系
faculties	n. 系，学院；才能，能力；全体教员
staff	n.全体职员
retire	v.退休
housing office 住宿办公室
讲座学科词汇：
讲座场景 A-- Art 艺术
Art 艺术
美术：
fine art	[ɑ:t] n.美术
academy	n.学院；研究院
art academy	[əˈkædəmi] n.艺术学院
gallery	n.画廊
studio	n.工作室；画室
salon	n.沙龙，美术展览馆
exhibition	n.展览（会）
convention	n.大会；惯例，习俗
the Renaissance	n.文艺复兴
contemporary art	[ɑ:t] n.当代艺术
tribal art	[ɑ:t] n.部落艺术
abstract art	[ɑ:t] n.抽象派
garde	n.前卫派
realism	n 现实主义
impressionism	n.印象主义
impressionistic style	印象派风格
	n.达达派，达达主义
neoclassical	adj.新古典主义的
realistic	adj.现实主义的
minimalist	n.简单抽象派艺术家
precursor	n.先驱
figurehead	名誉领袖
critic	n.批评家
amateur	n. 业余艺术家
oil painting 油画
water color 水彩画
engraving	n.版画
mural painting	/ fresco['freskəʊ]n.壁画
cave art	[ɑ:t] n.洞穴壁画
charcoal drawing	木炭画
sketch	n.速写/素描
caricature	n.漫画
animatorn.漫画家
panorama	n. 全景画
calligraphy	n.书法
sculpture	n.雕塑
statue	n.塑像
bust	n.半身雕塑像
sculptor n.雕塑家
decoration	= adornment[əˈdɔ:nmənt] n.装饰品
stained glass	n.彩色玻璃
fabric	n.纤维织物
weaving	n.织动，编织
mosaic	n.马赛克
ceramics	n.制陶术，制陶业
work	[wə:k] n.绘画作品
masterpiece	n.杰作
autograph	真迹
original	n.原作
replica	['replɪkə]复制品
fake	adj.假的
genuine	adj.真正的
brushstroke	[strəuk] n.一笔，绘画技巧
texture	n.质地，纹理
perspective	透视画法
brush	n. 画笔
drawing board 画板
canvas	n.画布，帆布
pigment	颜色，色素
ivory	n.象牙；乳白色
purple 紫色
indigo	靛蓝
layer	n. 垫片，层
framing	n.装框
paste	v.裱糊
scene	n.景色
nature scene	[si:n] n.场景，景色
landscape	n.风景
posture	n.姿势
facial	adj. 面部的，表面的
gesture	n.造型
printing press	[pres] n.印刷机
lightproof	adj.不透光
image	n. 影像
prehistory	n.史前
era	n.时代；年代；纪元
season	n. 适合某种活动的季节,期间
rank	v.分等级
appeal	v.对……有吸引力
make a name	[ə] [ˈneim]v.出名，成名
clergy	n.神职人员；牧师；僧侣
	[tʃə:tʃ] n.基督教教会
monastery	n.修道院；僧侣
prayer book	[buk] n.祈祷书
knight	n. 骑兵，骑士
戏剧电影摄影：
drama	n.戏剧
dramaturge	n.剧作家
tragedy	n.悲剧
puppet show	n.木偶剧
script	n.剧本
early version	[ˈvə:ʃən]n.早期版本
theatrical text	n.戏剧文本
producer	n. 制片人
film	n.=movie [ˈmu:vi] n.=motion picture [ˈməuʃən] [ˈ piktʃə]n.电影
production	n.作品，成品，电影制片
director	n.导演
documentarist	n.纪录片导演
documentary	n.纪录片
portray	vt.描绘，扮演
cast	v. 指定角色
audition	v. 在试演中评估某一人物
performer	n.表演者
acrobat	n.杂技演员
juggler	n. 玩杂耍的人
mime	n. 滑稽演员，哑剧演员，丑角
clown	n. 小丑
puppeteer	n. 演木偶戏的人
pantomime	n.哑剧表演
minstrel	n. 诗歌演唱者
audience	n.观众，听众，读者
theater	n. =cinema [ˈsinimə] n.电影院
scenery	n.舞台布景
imitation	n.道具
costume	n.装束
makeup	n.化妆品
characteristic	n.特征，特质
	n.刻板印象，成见，定型行为
hybrid	n.混合；混血
narration	n.叙事，讲述
standard	n.标准
framework	n.结构
photography	n.摄影
film	n. 胶片
expose	v. 曝光，暴露
exposure	n.曝光
sensitized paper	n. 感光纸
emulsion	n. 感光乳剂
tech	n.高科技
equipment	n.设备
processing	n.处理
entertain	v.娱乐
pioneer	n.先驱
innovator	n.改革者
inventor 发明家
mechanic	机械工
proprietor	业主
feminist	女权主义者
humanitarian	人道主义者
apprentice	学徒
disciple	n.学徒
crew	n.全体人员
mortal	犯人
renowned	adj. 著名的
household adj.家庭的/家喻户晓的
classic adj.经典的
traditional	adj.传统的
immortal	adj.不朽的/神
unique adj.唯一的/独特的
versatile	adj.（人）多才多艺的（物）多功能的
innocent	adj.天真的/无罪的
romantic adj.浪漫的
odd adj.怪诞的/奇数的
erratic	adj.奇怪的
eccentric	adj.古怪的
weird adj.怪异的/不可思议的
emotional adj.情绪的/情感的
emotive adj.感人的
sentimental	adj.感伤的/多愁善感的
cheerless adj.无精打采的/无生命力的
clumsy	adj.笨拙的
rigid	adj.僵化的
spare	adj.简朴的
zigzag	adj.曲折的
symbolic	adj.象征性的
contemplative	adj.沉思的；冥想的
sarcastic	adj. 讽刺的
authentic	adj.真正的，真实的；可信的
accessible	adj.易接近的；可进入的；可理解的
daydream	n.白日梦
nightmare	n.噩梦
音乐：Music
folk music 民间音乐
hillbilly music	乡村音乐
chamber music	[ˈmju:zik] n.室内音乐
symphony	n. 交响乐
	[ˈmju:zikəl]n.百老汇音乐剧
musician	n.音乐家
composer	n.作曲家；作家
critic	n.评论家；批评者
choir	n. 合唱队
chorus	=choir[ˈkwaiə]n.合唱队
noten.音符
step	n.音级
scale	n.音阶
tone	n.音调
pitch	n.音高
volume	n.音量
register	n.音域
solo	独奏/独唱
harmony n.和声
chord	n.和弦
melody	n. 旋律；歌曲
rhythm	n.节奏韵律
rhythmic patterns	n. 有节奏的模式
notation	n.谱号 (musical notation: 音乐记谱)
score	n.乐谱
composition	n.乐曲
movement n. 乐章
lullaby	催眠曲
sonata	奏鸣曲
serenade	小夜曲
vocal music 声乐
band music / wind music 管乐
orchestra	n. 管弦乐队
conducting 指挥
podium	指挥台
accompaniment	n.伴奏
musical instrument 乐器
string instrument	[ˈinstrumənt] n.弦乐器
keyboard instrument 键盘乐器
percussion instrument	[ˈinstrumənt] n.打击乐器
violin	n.小提琴；小提琴手
viola	n.中提琴，中提琴演奏者
cello	n.大提琴
fhorn 号；喇叭
clarinet	n.单簧管；竖笛，黑管
pound drum 击鼓
formal	adj.正式的
improvisational	adj.即兴的
fanatical	狂热的
建筑：Architecture
architect	n.建筑师
building technique 建筑工艺
crafting n. 工艺；手工
aesthetic	adj.美学的
school	n.学派
guild	n.协会
design 设计
design element 设计元素
nterior design	n.室内设计
construct	n.结构
compact structure	[ˈstrʌktʃə] n.紧凑的结构
component	n.零件，构件
composing	n. 组成
tension	n.绷紧状态
cube	n.立方体
facade	n.（建筑物的）外立面，尤指正面
alignment	n.直线排列
parallel	adj.平行的
fine	adj.（区别）微小的；细微的
flat	adj.扁平的
immense	adj.极大的
molten	adj.熔化的；熔融的
archives	档案馆
planetarium	天文馆
aquarium	水族馆
skyscraper	n.摩天大楼
office building 写字楼
cabin	n. 小木屋
cathedral	n.大教堂
mosque	清真寺
castle	n.城堡
Gothic	adj.哥特式的
pyramid 金字塔
the statue of liberty 自由女神像
the triumphal arch	凯旋门
celebrated	adj.著名的
roof	n.屋顶
dome	n.穹顶
arch	n.拱（连柱的）
ceiling	n.天花板
marble slab	n.大理石板
skeleton	n.框架结构整体框架
steel girder	[ˈgə:də] n.钢梁
metal-frame 金属结构
mat	n.垫子
pedestal	n. 基架，基座
doorway	n.门口
corridor	n.走廊
staircase	n.楼梯
electric elevator	n.电梯
dwelling	n.住处，居住空间
fountain	n.喷泉
lamp	n.灯
chimney	n.烟囱
drainer	n.下水道装置,滤水器
sewer	n.排水沟
pipeline	n.管道，输送管道
canal	n.运河
timber	n.木材
splint	n.薄木条
lime	n.石灰
plaster	n.石膏
mortar	n.砂浆, 灰浆
tile	n.饰面砖，瓷砖
fiber	n.纤维
hemp	n.大麻纤维
new material 新材料
prototype	n.原型
portrait	n.肖像
sphinx	n.狮身人面像
sculpt	v.雕刻
pastel	n.彩色蜡笔画
parchment	n.羊皮纸
decoration	= adornment[əˈdɔ:nmənt] n.装
饰品
pour	v.浇注
erect	v.竖立，建立
hammer	v.锤打
imold	v.塑造
cohere	v.粘合
converge	v.聚合于，集中于一点
span	v.（桥、拱等）横跨
fabric weaving	n.纺织，编织
城市规划：City Planning
layout	n.布局
downtown	n.市中心
suburb	n.郊外
rural area	= [ˈruərəl] [ˈɛəriə]n.农村
residential area	[ˈɛəriə]n. 住宅区
local resident	[ˈrezidənt] n.当地居民
dweller	n.居民
inhabitant	n.居民
sidewalk	n.人行道
pedestrian mall	[mɔ:l] n.步行街
limits	n.禁区，禁止进入
transportation hub	[hʌb]n.中转港
bus terminal	[ˈtə:minəl]n.公车终点站
facilitate	v.提供便利
privately owned	adj.私有的
publicly owned	adj.公有的
public utility	n.公用事业
vehicle	n.交通工具
lot	[ˈɛəriə]/ [lɔt]=car park [kɑ:] [p
ɑ:k]
stopping place	[pleis]n.停车场
automobile	=car [kɑ:]=vehicle [ˈvi:ikəl]n.汽车
subway station	[ˈsteiʃən]=underground[ˌʌnd
əˈgraund]n.地铁
文学：Literature create
genre	n.文体
fairy tale	n.童话；神话
folk tale	[teil]n.民间故事
mythology	n.神话；神话学；神话集
allegory	n.寓言
legend	n.传说
novel	=fiction [ˈfikʃən]n.小说
science fiction	[ˈfikʃən]n.科幻小说
essay	n.散文
descriptive prose	描写性散文
narrative prose	叙述性散文
poetry	=poem [ˈpəuim]n.诗歌
autobiography	n. 人物传记
character sketch	[sketʃ]n.素描，人物速写”
lyrics	n.抒情诗
ballad	民谣
proverb	谚语
editorial	n. 社论
type	n.类型
style	n.风格
works	n.作品
author	n.作者
story tellers	n.说故事的人
satirist	讽刺作家
biographer	自传作家
imagist	意象派诗人
troubadour	n.行吟诗人
literacy	n.读写能力；精通文学
literary criticism 文学批评
literary studies 文学研究
comment	n.评论
schools of literature 文学流派
realism	现实主义
surrealism	超现实主义
modernism	现代主义
aestheticism	唯美主义
character	n. 人物,角色，性格
leading character 主人公
main character	/ [mein] [ ˈ kærikt
round character	[ˈkæriktə]n.主角
minor characters	[ ˈ kæriktə ]=flat character
	n.配角
personalities	[ˌpə:səˈnæliti]n.人物
个性
s trait	[treit]n.人物特质
model n.人物原型
	n.刻板印象，成见，定型行为
background	n.背景
setting	n.场景
prelude	序曲
prologue	n.序言
main plot	n 主要情节
obligatory scene	[si:n]n.必须的情节
incident	n.事件.
ending	= denouement [deiˈnu:mɑŋ] n.结局
quotation	n.引用语
fortune	n.命运，运气
servant	n.仆人
master	n.主人
royalty	n.皇室
prince	n.王子
princess	n.公主
knight	n.骑兵，骑士
chivalry	n.侠气，骑士精神
clergy	n.神职人员；牧师；僧侣
religion	n.宗教；宗教信仰
	[tʃə:tʃ] n.基督教教会
museum	n.博物馆
entertainment	=recreation [ˌrekriˈeiʃə
amusement	n.娱乐
formula	n.准则，公式
universal truth	[tru:θ]n.真理
the inciting	[inˈsait iŋ]n.刺激
logical	adj.合乎逻辑的
appreciate	vt.欣赏
戏剧（见艺术电影摄影）：
drama	=theater [ˈθiətə]=play [plei]n.戏剧
opera	n.歌剧
made play	[meid] [plei]n.佳构剧
comedy	n.喜剧
portray	vt.描绘
舞蹈：Dance
ballet	n.芭蕾舞
choreography	n.编舞
choreographer	舞蹈编排家
toeshoe	n.芭蕾舞鞋
讲座场景 B-- Social Science 社会科学
考古：Archaeology
Stone Age 石器时代
Paleolithic	旧石器时代的
age	[ˌpæliəuˈliθik] [ˈpiəriəd]/
[eidʒ]
late Stone Age	[əuld]/ [leit] [stəun] [eidʒ]n. 旧石器时代
Mesolithic	中石器时代的
Neolithic	新石器时代的
age	[ˌni:əuˈliθik] [ˈpiəriəd]/
[eidʒ]
New stone age	[stəun] [eidʒ]n.新石器时代
Bronze Age	（青）铜器时代
Iron Age 铁器时代
primitive	n.原始人，adj 原始的
ancestor	祖先
cave man 山顶洞人
nomad	n.游牧民
clan	氏族
tribe	部落
alliance	=federation [ˌfedəˈreiʃən]n.联盟
homogeneous	同一种族（种类）的
archeologist	考古学家
antiquity	古代，古老
ancient civilization	古代文明
tomb	= [tu:m]n.坟墓
ruins	遗迹，废墟
remains	遗产/遗骸
skull	颅骨
cranial	颅骨的
historicalrelic	[ˈrelik]n.遗迹
cultural relics	文物
relic	遗物，文物
antique	古物/古董
artifact	手工艺品
utensil	n.餐具，炊具
cooking container	[kənˈteinə]n.容器
canoe	独木舟
obsidian	n.黑曜石
covert	n. 隐藏处
shelter	n.庇护所
religion	n.宗教
ritual	n.（宗教）仪式
originate	起源于
inhabit	vt.居住于
bury	v.埋葬
excavate / unearth v.挖掘
excavation	n.挖掘
历史：History
era	n.时代；年代；纪元
prehistory	n.史前
Greek	[rəum]/ [gri:k]n. 古罗马/希腊
medieval	adj. 中世纪
Europe	n.欧洲
Britain	n.英国
Italy	n. 意大利
	n. 罗马
Greek	n. 希腊
Egypt	n.埃及
France	n.法国
Germany	n.德国
Spain	n.西班牙
Turkey	n.土耳其（Turkish）
Netherlands	=Holland [ˈh ɔ lənd] n.荷兰（Dutch 荷
兰人）
Canada	n.加拿大（Canadian [kəˈneidiən] n.加拿大人）
Mount Rushmore 拉什莫尔山（位于美国南达科他州） 总统山；
人类学：Anthropology
anthropologist	人类学家
paleoanthropologist	古人类学家
ecological anthropologist	生态人类学家
psychological anthropologist	心理人类学家
Native American	[əˈmerikən]n. 美洲原住民，印第安人
patriarchal	adj.家长的/族长的
哲学：Philosophy
philosophy	n. 哲学；哲理；人生观
s ethical theory	[ˈeθikəl] [ˈθiəri]n. 伦理学
Ancient Greek philosopher	[gri:k] [fiˈl ɔsəfə]n. 古希腊哲学家
Socrates	苏格拉底；Plato [ˈpleitəu]柏拉图；
Aristotle	亚里士多德
ideology	意识形态
intellect	n. 智力，理解力；知识分子；思维逻辑领悟
力；智力高的
happiness	n.幸福
fame	n. 名声，名望
external	adj. 外部的；表面的
optimism	n. 乐观；乐观主义
心理学：Psychology
baby	=infant [ˈinfənt]=nursling [ˈnəː sliŋ]n.婴儿
kid	n.儿童
teenager	n.十三至十九岁的人
young people	[ˈpi:pl] n.年轻人
adult	n.成年人
old people	[ˈpi:pl]=the aged[ ði:] [eidʒd]=elderly
people	[ˈpi:pl]
senior citizens	[ˈsitizənz]老年人
mature	vt.使成熟
majority	n.多数人
minority	n.少数人
conformity	n.从众
individual	n. 个体，个人
reliance	n. 依靠自己，自立
participate	v.参与
behaviorism	n.行为主义
psychoanalysis	n.精神分析
egocentric	adj.自我中心的；利己主义的
	[ˈprəuses]n.心理历程
mental	心理的
founder	n.创始人
Archimedes	n.阿基米德
mental process	[ˈprəuses]n.思维过程
thought	n.思想，想法
cognition	n.认识
cognitive capacity	[kəˈpæsiti]n.认知能力
ideomotor action	[ˈækʃən]n.意识，观念运动
motivation	n. 动机；积极性；推动
intention	n.意图，目的
intuitive	adj.直觉的
hypotheses	n.假定；臆测
conscience	n.道德心，良心
virtuous	adj. 善良的；有道德的
curiosity	n.好奇心
generous	adj.慷慨的，大方
identity	n.身份；同一性
fame	n.名声，名望
spiritual	心灵的
soul	n. 灵魂；心灵
physical	身体的，物质的，物理的
behavior	n. 行为，举止；
habit	n.习惯
muscle	n.肌肉
sign language	[ˈlæŋgwidʒ]n.手语，符号语音
throat	n.喉咙，嗓子
laryngeal	adj.喉部
larynx	= voice box [vɔis] [bɔks]喉头
subjective	adj.主观的
objective	adj.客观的
negative electrode	/ [ˈnegətiv] [ɪˈlektrəʊd]
正/负电极
maze	= labyrinth [ˈlæbərinθ]n.迷宫
questionnaire	n.问卷
subject	n.受实验对象
disadvantage	n.缺点
obsession	n.困扰
deaf	adj. 聋的
blind	adj.盲
abnormal	adj.反常的
distracted	adj.心烦意乱的
child amnesia	[æmˈni:ziə] n 儿童健忘症，记忆缺失
语言学：
linguistics	.语言学
	[ˈɪndəʊ] [juərəˈpi:ən] n. 原始印欧语
grammar	n.语法
verb	v.动词
noun	n.名词
adjective	n.形容词
经济学 Economics 商业 Business
merchant	n.商人
adman	n.广告人
bidder	n.投标者
client	n.客户
potential customer	[ˈkʌstəmə]n.潜在客户
skilled labor	[ˈleibə]n.熟练工人
employer	[ˈəunə] = [imˈplɔiə]老板
business conference	[ˈkɔnfərəns] =seminar[ˈ seminɑ:]n.会议
industrial revolution	[ˌrevəˈlu:ʃən]n.工业革命，
产业革命
industry	n.产业，工业
infrastructure	n.基础设施
	[ˈklʌstə]n.产业集群
alliance	=federation [ˌfedəˈreiʃən]n.联盟
collaborate	vi.合作；协作
urbanization	n.都市化
prosper	vi.繁荣
flourish	n. 兴旺；茂盛
affluence	n.富裕，富足
poverty	n.贫困
boom and bust	[ænd] [bʌst] 繁荣与萧条
collapse	n./vt.崩溃
out of business 歇业，破产
outofwork	[əv, ə, ɔv] [wə:k]n.失业
Great Depression	[diˈpreʃən]n.大萧条
dotcom crash	[dɒtˈkɒm] [kræʃ]n.互联网泡沫
tulip mania	[ˈmeiniə]n.狂热
irrational	adj.不理性的
sophisticated	adj.世故的，老练的；复杂的，尖
端的
speculation	n.投机
conflict	n.冲突
variation	n.变种
panic	n.恐慌
consumerism	n.消费主义
horticulture	= [ˈhɔ:tiˌkʌltʃə]n.园艺
remote mountainous region	[ˈmauntinəs] [ˈri:dʒən]n. 偏远山区
trademark	= [ˈtreidmɑ:k]n.品牌，商标
product	n.产品
commodity	n.商品
luxury	n.奢侈品
specimen	n.样本
service	n.服务
native to	[tu]原产至
hail from	[frɔm]来自于，出产于
retail	n.v.零售
promissory note	[nəut]n.本票
revenue	=income [ˈinkʌm]n.收入
disposable income	[ˈinkʌm] -money [ˈmʌni]n.可
支配收入
per capita	人均
subsistence level 收支平衡的生活水平
subsistence	n.存活，生活
annual budget	[ˈbʌdʒit]n.年度预算
borrowing	n.借款
bank loan	[ləʊn]银行贷款
interest	利息
check	支票；收据；账单
cost	n.成本
rent	n.租金
tax	n.税金
profit	n.利润
withdraw	从银行账户中提款
annual budget	[ˈbʌdʒit]n.年度预算
tax incentive	[inˈsentiv]n.税收优惠
federal subsidy	[ˈs ʌ bsidi]=financial
assistance	[əˈsistəns]n.财政资助//补贴
foundation	=fund [fʌnd]n.基金会
the National Endowment for the Arts
foundation	[ˈnæʃən(ə)l] [inˈdaumənt] [fə] [ðə] [ɑː ts]n. 美国艺术基金会
gold	n.金子（区：goal 目标）
monetary	adj.货币的，财政的
commercial	adj.商业的；营利的
guarantee	v.担保
mortgage	n./vt.抵押
auction	n./vt.拍卖
patron	=sponsor [ˈspɔnsə]n.赞助人
patronage	n.资助，赞助
mass communications	[kəˌmju:niˈkeiʃənz]大众传播工具
media	=communication[kəˌmju:niˈkeiʃən]n.媒体
advertisement	n.广告
advertising plan	[plæn]n.广告策划
billboard	n.公告牌
slogan	n.标语；呐喊声
target age group	[eidʒ] [gru:p]n.目标年龄群
survey	[riˈsə:tʃ]/ [ˈsə:vei]市场调
查
statistics	n.统计学
社会学：Sociology
meme	n.文化基因
longevity	n.寿命
fecundity	n.繁殖力，复制能力
fidelity	n.保真度，精准
accuracy	n. [数] 精确度，准确性
calendar	n. 日历；[天] 历法；
Jupiter	n. [天] 木星；朱庇特（罗马神话中的宙斯神）
monumental	adj. 不朽的；纪念碑的；非常的
enormous	adj. 庞大的，巨大的；凶暴的，极恶的
政治类：Politics
American Revolution 美国革命/独立战争
Independence War 美国独立战争
American Civil War 美国内战
the Second World War 第二次世界大战
military	adj.军事的
warrior	n. 战士
fifty states 55 个州
federal system	联邦制
Congress	美国国会
Senate	参议院
Democrats	民主党
Republicans	共和党
election	选举
vote	投票
veto	否决
council	n.委员会
legislation	立法
constitution	宪法
justice	n. 司法，法律制裁
diplomat	n.外交官
bureaucracy	n.官僚主义
anarchism	n.无政府主义
centralized	adj.中央集权的
radical	adj.激进的,根本的
patriotic	adj. 爱国的
inspire	vt. 激发；鼓舞；
release	v.释放
colonize	v.拓殖，殖民
immigrant	n.移民
social status	n.社会地位
讲座场景 C—Life Science 生命科学
动物学：
biology	生物学
speciology	n. 物种学
zoology	n.动物学
microbiology	微生物学
marine biology 海洋生物学
entomology	n. 昆虫学
ornithology	n.鸟类学
cell biology	n.细胞生物学
biochemist	n.生物化学家
paleontologist	n.古生物学者
creature	n.生物
organism	n.有机物，微生物
microbe	微生物
plankton	浮游生物
invertebrate	n.无脊椎动物
vertebrate	脊椎动物
amphibian	n.两栖动物
reptile	n.爬行动物
herbivore	n. 食草动物
	a.食草的，草食的
carnivore	食肉动物
omnivorous	a.杂食的
ruminant	n.反刍动物
mollusk	n.软体动物
land creature	[ˈkri:tʃə]陆地生物
cold	blood animal [blʌd] [ˈæniməl]n.冷血动物
warm	blood animal [blʌd] [ˈæniməl]n.热血动物
mammal	n. [脊椎] 哺乳动物
primates	灵长目动物
endangered species 濒危动物
species	n.物种
breed	n.品种
monogamous 一夫一妻的/一雌一雄的
polyandrous	一妻多夫的/一雌多雄的
polygamous	一夫多妻的/一雄多雌的
community	动物的群落或人的部落
flock	（牛、羊等）群
herd	兽群
swarms	/[swɔrm]（昆虫等）群
生理生化：
respiratory system	n.呼吸系统
digestive system 消化系统
nerve system	n.神经系统
circulatory	system 循环系统
hormonal	system 内分泌系统
reproductive system 生殖系统、urinary system 泌尿系统
immune system	[ˈsistəm]n.免疫系统
motor system n.运动系统
breed	(名词)品种，（动词）繁殖
reproduce	/[,riprə'dus]繁殖
offspring	n.后代
crossbreed	v.（使）杂交
sperm	n. 精子
spawn	（鱼、虾、蛙等）孵
fertilizer	使…受精 n.肥料
unfertilized egg	未受精卵
fertilized egg	n.受精卵
pregnant	a. 怀孕的
embryo	n.胚胎
hatchling	n. 刚孵化的幼体
incubation	孵化
fledglings	n.雏鸟
cell	n. 细胞.蜂房
cytoplasm	n.细胞质
cell membrane	n.细胞膜
cell wall	n.细胞壁
nucleus	n.细胞核
organelle	n.细胞器
skin cells	[selz]n.皮肤细胞
nerve cells	[selz]n.神经细胞
unicellular	adj.单细胞的
multicellular	adj.多细胞的
renewing	n.更新
metabolism	n.新陈代谢
hormone	n.激素，荷尔蒙
insulin	n.胰岛素
secretion	n.分泌，分泌物
anatomy	n.人体解剖
organ	n. 器官
vestige	n.退化器官
liver	n.肝脏
lung	n.肺
kidney	n.肾
stomach	n.胃
pancreas	n.胰
tissue	n.组织
vessel	n.血管
tendon	n.腱
membrane	n.膜
gland	n.腺
digestive gland	消化腺
digestive enzyme 消化酶
tentacle	n. 触角，触须
jaw	n.颌, 颚
tongue	n.舌头
valve	n.瓣膜
skeletal	adj. 骨骼的
vertebra	n. 脊椎骨= spinal ['spaɪnl]cord 脊椎
rib	n.肋骨
fingerprint	n.指纹
nail	n.指甲
division	n.部分
beak	n.喙，（鹰等的）嘴
bill	（鸟）嘴
tooth	-teeth[ti:θ]n.牙齿
toothless	adj. 无齿的
compound eye	[ai]n.复眼
fin	n.鱼鳍
scale	n.鱼鳞
forelimb	n.前肢
limb	n. 肢，臂；分支
wing	n.翅膀
feather	n. 羽毛
tail	n.尾
卫生与疾病：
hygiene	卫生
hygienic	adj.卫生学的（hygiene [‘haidʒi:n] 卫
生学）
sanitation	公共卫生；卫生设施
disease	n.疾病
diagnose	v.诊断
drug	n.药物
medicine	n.医学，药
dental clinic 牙医诊所
surgeon	n.外科医生
virus	n.病毒
fungi	n.真菌类
yeast	酵母（菌）
parasite	寄生虫
parasitic	a. 寄生的，寄生虫的
inflection 传染 / 感染
paralysis	n.麻痹, 瘫痪
cardiac	adj.心脏(病)的
antibiotic	n.抗生素
antibody	n.抗体
vaccine	n.疫苗
fungicide	n.杀真菌剂
营养学：
nutrient	n. 营养物质
calorie	卡路里（热量单位）
protein	n.蛋白质
starch 淀粉
glucose	n.葡萄糖
carbohydrate (starch) 碳水化合物（淀粉）
vitamin	n.维生素，维他命
malnutrition	n.营养不良，营养不足
decaffeinated	adj. 不含咖啡因
toxic	adj.有毒的
toxin 毒素
植物学：
botany 植物学
botanical / botanic 植物学的
botanist	n.植物学家
herb	n.草本植物
parasite plant	寄生植物
aquatic	plant 水生植物
horticulture	园艺学
system 系统
forest	n.森林
jungle	n.热带丛林
tropical rain forest	n.热带雨林
Tropical savanna forest	n.热带
稀树草原
deciduous forest	n.落叶林
Deciduous monsoon forest	n. 落叶季雨林
Temperate rain forest	n.温带雨林
Temperate evergreen forest	n. 温带绿叶林
subarctic	adj.亚寒带
flowering tree	[tri:]n.会开花的树
lumber	n.木材
lawn	草坪
grassland	n.草原
meadow	n.草地；牧场
prairie	n.大草原；牧场
ranch	n.大农场；大牧场
shrub	= bush[brʌʃ] 灌木丛
cluster	n.串，簇；群，组 vi.群集，丛生
marsh	n.沼泽；湿地
beach	n.海滩
alpine region	n.高山区
blossom	花
root	n. 根
stem	n.茎
stalk	杆
petal	n.花瓣
bud	花蕾
column	花柱
pistil	n.雌蕊
stamen	n.雄蕊
wither / shrivel / fade 凋谢
seed	n. 种子
germinate	vi. 发芽.
	[spraʊt]嫩芽，抽枝
rhizome	n. 根茎，根状茎，地下茎
trunk	树干
bark	树皮
crown	n.树冠
canopy	n.天篷：树林中最上面一层
branch	树枝
twig	小树枝
leaf	（leaves 复）n.叶子
leaflet	小叶
peel(skin)[pil]果皮
husk	（干）果壳/（玉米）苞叶
	果壳
barren	贫瘠的；不生育的
pesticide	n.农药 | 杀虫剂
insecticide	n. 杀虫剂，农药
	粮仓
annual 一年一生的
perennial	多年一生的
rosette	（叶的）丛生
mutualism	n.共生
symbiosis	n.共生，共生关系
symbiotic	adj.共生的
考过的动物：
reptile	n.爬行动物
rodent	n.啮齿动物
gorilla 大猩猩
chimpanzee	n.黑猩猩
baboon	n.狒狒
anthropoid	a.类人猿的
beast	野兽
wolf	n.狼
cheetah	猎豹
bear	vt.熊
lions	n.狮子
rat	=mouse [maus]（复数 mice）n.鼠
squirrel	n.松鼠
kangaroo	n.袋鼠
marmot	n.土拨鼠
chipmunk	n.花栗鼠
meerkat	n.猫鼬
elephant	n.大象
mammoth	n.猛犸象，长毛象
cattle	n.牛
bison	n.美洲野牛
buffalo	n.水牛
rhinoceros	n.犀牛
zebra	n.斑马
hippopotamuses	=hippo['hipəu]n.河马
deer	n.鹿
camel	n.骆驼
antelope	羚羊
rabbit	n.兔子
pigeon	n.鸽子
crow	n.乌鸦
eagle	n.鹰
hawk	n.鹰
owl	n.猫头鹰
songbird	n.鸣禽
hummingbird	n.蜂鸟
bat	n.蝙蝠
colubrid	n.无毒蛇类
venomous snake	[sneik]n.有毒的蛇
dinosaur	n.恐龙
Tyrannosaurus rex	[reks]n.霸王龙
alligator	= crocodile[ˈkrɔkədail]n.鳄鱼
turtle	龟
snake	n.蛇
frog	n.青蛙
chameleon 变色龙
lizard	n.蜥蜴
snail	n.蜗牛
penguin	n.企鹅
otter	n.水獭
shrimp	n.虾
crayfish	n.龙虾
clam	n.蛤
crab	n.螃蟹
coral	n.珊瑚
beaver	n.海狸
dolphin	n.海豚
starfish	n.海星
octopus	n.章鱼
whale	n.鲸鱼
eel	n.鳗鱼
flounder	n. 比目鱼
squid	n.鱿鱼
jellyfish	n.水母
oyster	n.牡蛎
sponge	海绵
insect	n.昆虫
bug	n.虫子
worm	虫/蠕虫
caterpillar	n.毛虫
pest	n.害虫
parasite	寄生虫
spider	n.蜘蛛
cockroach	n.蟑螂
ant	n.蚂蚁
termite	n.白蚁
fly	n.苍蝇
hornet 大黄蜂
mosquito	n.蚊子
moth	n.飞蛾
butterfly	n.蝴蝶
考过的植物：
paleontology	a.古生物
vegetation	n.植物
rain forest	n.雨林
deciduous tree	a.落叶/阔叶树
birch	n.桦树
eucalyptus	n.桉树
maple	n.枫树
oak	n.橡树
conifer tree	针叶树
softwood	n.针叶树
evergreen 常青树
redwood 红木树
pine needle	[pain]n.松叶/松针
algae	n.藻类
fungus	n 真菌，菌类
	n.真菌；菌类；蘑菇
lichen	n.地衣；青苔
moss	n.青苔，藓类
crop	n.农作物
	['sɪrɪəl 谷物，谷粒
millet	粟，小米
wheat	小麦
corn	=maize [meiz]n.玉米
potato	n.土豆
onion	n.洋葱
tomato	n.番茄
Nightshade family	[ˈfæməli]n.茄科
lettuce	莴苣
pumpkin	南瓜
tulip	n.郁金香
cactus	n.仙人掌
orchid	n.兰花
spartina	n.大米草（盐滩）
Animal Behavior:动物行为
passive	a.被动的/enactive [i'næktiv] a.主动
的
habitat selection	[siˈlekʃən]n.栖息地选择
habitat	n.息地
recreate	v.再建（栖息地）
burrow	n.洞穴
nest	n.巢
survival	n.生存
territorial	a.领地的
communal	adj.群居的
social 群居
solitary 独居
circumstance	= environment[inˈvaiərə
nmənt]n.环境
population density	[ˈdensiti]n.居住密度
quiescent	adj.休眠的
hibernate	n.冬眠；蛰伏
migrate	v.迁徙
soar	v.振翅飞行
glide	v. 滑行
nomadic	adj.游牧的；流浪的
domesticate	v.驯养
flexible	adj.柔韧的
stretch	n.伸展
exhale	v.呼气
inhale	v.吸气
forage	v.觅食
diving 潜水 / 跳水
mating ritual	[ˈritʃuəl]求偶仪式
mate	n.交配
stimulus	n.刺激
drive	=urge[ə:dʒz]n.驱动，驱动因素，强烈的愿
望
expel	v. 喷出，发射
displacement	n.取代，换位
grooming	n.整理（羽毛）
reproduce	v.繁殖
lags eggs	下蛋
incubate	v.孵化
offspring	n.后代
larva	n.幼虫
molting	n.蜕皮
fledglings	n.雏鸟
hatchling	n.刚孵化的幼体
tend	v.照顾
pollinate	v.授粉，传粉
agent	n.中介
spread	v.扩散，传播
camouflage	vt.伪装
shield	v.防御，保护
defend	v.防卫
protective camouflage n.保护色
prey	-[prei]捕食者—被捕食者
enemy	n.敌人
pursue	v.追捕, 追击
sting	v.螫
injury	n.伤害
eliminate	v.除去
prime	a.首要的，最好的/ secondary [ˈsekəndəri,
-deri] a.次要的，第二的
higher	a.较高/ lower [ˈləuə]a.较低
irrelevant	a.不切题，不相关
inappropriate	adj.不恰当.
horizontal	a.水平的
vertical	a.垂直的
underneath	n.下面
适应：Adaptation
the weather	[ˈweðə] =climate [ˈklaimit] n.气候
microclimate	n.小气候
harsh	a.（气候）恶劣的
primitive	a.远古的
hibernation	n.冬眠
burrow	n.洞穴
territorial	a.领地的
absorb	v.吸收
soak up	v.吸收
respiration	n.呼吸作用
photosynthesis	n.光合作用
photolysis	n.光解作用
chlorophyll	叶绿素
chloroplast	n.叶绿体
pigment	n.色素
catalyst	n.催化剂
crossbreed	v.（使）杂交
yield	n.产量 v.产出，生出
dehydrate	vi.脱水
edible	a.可食的
greeting	n.打招呼
ceremony	n.仪式，典礼
individual	n.个体，个人
colonize	vt.殖民
colonist	/colonizer['kɔlənaizə]n.殖民者
osmosis	n.渗透，渗透作用
进化 : Evalution
ancestry	=ancestor[ˈænsəstə]n. 祖先
evolution	n.演变，进化
evolve	v.(使)演变，进化
the missing link	[ˈmisiŋ] [liŋk]n.进化缺环
Darwinism	达尔文学说
species	n.物种
survival	n. 幸存，生存
victim	n.牺牲品
extinction	灭绝
mass extinction	n.大量消亡
decline in the number 数量减少
交流：Communication
vocalization	n. 发声，
acoustic	a. 声学，听觉的
acoustic spectrum	[ˈspektrəm]n.声谱
sound waves	[ˈweivz]n. 声波
infrasound	n.次声
ultrasound	n.超声波.
reflection	n.反射
echolocation	n. 回声定位
ground clutter	[ˈklʌtə]n.地面杂乱回波
high frequency sounds	[ˈfri:kwənsi] [saundz]n.频
率
ultrasonic pulse	[ˌʌltrə'sɔnik] [pʌlsiz]n.脉冲
vision	n. 视力
生物工程 DNA
.遗传变异：
speciology	n.物种学
bio-diversity 生物多样性
heredity	n.遗传，遗传性
duplicate	v.复制
descendant	adj. 下降的；祖传的|n. 后裔； 子孙
DNA 脱氧核糖核酸
chromosomes	n.染色体
sequences	n.序列
infectious agent	n.传染因子
	n.遗传，遗传性
gene	n.基因，遗传因子
genetic	adj. 遗传的；基因的；起源的
genetic code	[kəud]n.基因代码
genetic engineering 遗传工程
genetic material	n.遗传物质
genetic structure	n.遗传结构
genic mutation	[mju:ˈteiʃən]n.基因突变
variation	变异
mutation of species 物种变异
amino acid	n. [生化] 氨基酸
nucleic acid	n.核酸
ribonucleic acid	n.核糖核酸(略
作 RNA)
enzyme	n.酶
telomerase	n.端粒酶（核糖体蛋白酶）
生态学
生态平衡（见自然科学环境科学）：
ecology	n.生态学
ecologists	a.生态学家
ecological tourism	[ˈtuərizəm]n.生态观光
ecological	)-tourists [ˈtuərist] n.生态旅
游者
ecological	)-system [ˈsistəm] =
ecosystem	n.生态系统
wildness 野生/天然
habitat	n.栖息地
food chain	食物链
wild environment 野生环境
preservation	保护
environment protection 环境保护
soil	n.土壤
clay	n. [土壤] 粘土；泥土
permafrost	n.永久冻土
weathered	n.风化.
fertilizers	n. 肥料
sediments	n. 沉淀物
agricultural	a.农业的
artificially	ad. 人造地
interrelationship	n. 相互关系
organism	n.生物体；有机体；微生物
microbes	n.微生物，细菌
nectar	n.花蜜
pollen	n.花粉
pollinated	v.授粉
bird band	[bænd]n.鸟足识别环，鸟足带
labeled	adj.被贴标签的
nesting sites	[saits] n.筑巢区
trail	vt. 追踪；拖
migrate	vi. 移动；使移居；使移植
immigrate	vi.使移居入境
emigrate	vi.移居外国
migration routes	[ru:ts]n.迁徙路线
cease to exist	[tu:, tu, tə] [igˈzist] =extinct [ikˈ stiŋkt]
die out	[aut]v.灭绝
讲座场景 D—理科—Physical Science 自然科学
天文: Astronomy
	宇宙
infinite	无限的
cosmic	adj.宇宙的
cosmic radiation	宇宙辐射
space	n.太空
space debris	太空垃圾
celestial body (heavenly body) 天体
solar system	[ˈsistəm]n.太阳系
constellation	n.星座
	n.星系
intergalactic	adj.星系间的
cluster	n.星团
nebula	n.星云
star	n.恒星
stellar	adj.恒星的
interstellar	adj.恒星间的
interstellar matter	n.恒星间物质
	矮星
black hole 黑洞
quasar	n.类星体
zenith star	[stɑ:]n.天顶星
planet	n.行星
	n.小行星
asteroidal body	n.行星体
asteroid belt	[belts]n.小行星带
interplanetary	行星间的，太阳系内的
moon	n.月亮；卫星
moon	[mu:n]n.月亮
phase	n. 位相
phases of the Moon	[əv] [ðə, ði:] [mu:n] n.月相
new moon	n.满月
full moon	n.满月
meteor	流星
meteoroid	流星体
meteor showers	[ˈʃauəz]n.流星雨
meteorite	陨石
comet	n.彗星
sun spots	[spɔts]n.太阳黑子
solar corona	日冕
convection zone	对流层
chromosphere	色球
photosphere	色球层
solar prominence	日珥（发生在色球层）
flare 耀斑（发生在色球层）
partial eclipse	n.偏食
total eclipse	n.全食
on the far side of the moon n.远月点
orbit	n.轨道
axis	n.轴（plural: axes [‘æksi:z]）
twinkle	闪烁
illuminate	v.照亮，使明亮
spin	v.旋转
rotate	v.自转
revolve	v.公转
astronomy 天文学
astrophysics	天文物理学
astrology	占星学
pseudoscience	伪科学
geocentric	a.地心的 /地心论
heliocentric	adj.日心的
gravitation	a.重力，万有引力
law	n.定律；法律
paradox	n.悖论；似非而是的论点
astronaut	n.宇航员
seafarer	n.航海家
astronomer	n.天文学家
astronomical units	[ˈju:nits]n.天文单位（距
离）
planetarium 天文馆
astronomical observatory	天文台
space exploration	[ˌeksplɔ:ˈreiʃən]n.太空探索
space probe	[prəub]n.航天/空间探测器
space suit	[su:t, sju:t]n.宇航服
spacecraft	n.太空飞船 space ship[speis] [ʃ
ip] /shuttle [ˈʃʌtl]
advanced navigational tools	[ˌnævə'geiʃnə
instruments	n. 先进的导航设备
navigational aid	[eid]n.助航设备
rocket fuel	[fjuəl]n.火箭燃料
	abbr.=National Aeronautics and Space
Administration	[ˌeərəuˈnɔ:tiks] [ədˌminisˈ treiʃən] (美国)国家航空和宇宙航行局
satellite	n.人造卫星
sophisticated radar	[ˈreidɑ:]n. 精细的雷达
navigation	n. 航海
voyage	n.航行；航程
departure point	[pɔint]n.出发点，启程点
destination	n. 目的地，终点
observation	n.观察
calculation	n.计算
multiplying by	[bai]v.乘
subtract	v.减
putting in a decimal	[in] [ei] [ˈdesiməl]n.放入小数
（除）
permanent base	[beis]n.永久基地
phenomena	n.现象（phenomenon [fiˈnɔmənən]的复数）
position	n.位置 v.定位，安置
reference points	[pɔint]n.参照点，参考点
average depth	[depθ]n.深度
length	n.长度
angle	n.角度
sphere	n.球(体)
diameter	n.直径
square	adj.正方形的
straight	adj.笔直的
streamlined	adj.流线型的
elongated	adj.被拉长的
prolong	v.延长
chaotic	adj.无秩序
irregular	n.不规则的物体
giant	adj.巨大的
backward	a.向后的；反向的
fingerprint	n.指纹
footprint	n.脚印
primitive life	[laif]n.原始生命
light year 光年
leap year 闰年
telescope	n.望远镜
microscopic	a.微观的 /显微镜的
crystal prism	[ˈprizəm]n.水晶棱镜
interferometer	干扰仪
image	n.图像
resolution	高清晰度
infrared ray	[rei]n.红外线
ultrared	adj.红外线的
violet	- [ˈvaiələt]n.紫外线
visible light	[lait]n.可见光
reflected light	[lait]n.反射光
albedo	n.反照率 /反射率
ambient Light	[lait]n.环境光
rainbow	n.彩虹
spectrum	n.光谱
spectral lines of light	[lain] [əv, ə, ɔv] [lait]n. 光谱线
spectroscopy	n.光谱学
optical radiation	[ˌreidiˈeiʃən]n.光辐射
Electromagnetic radiation	[ˌreidiˈ eiʃən]n.电磁辐射
emission	发射，散发
lame reaction	[riˈækʃən]n.焰色反应
chemical element	[ˈelimənt] = composition. [ˌkɔmpə
ˈziʃən]n.化学成分
Helium	n.氦气 /氦
hydrogen	n.氢气，氢
oxygen	n.氧气，氧
vacuum	真空
water molecules	[ˈmɔlikju:lz]n.水分子
water	['rivɚs]/ [ˈwɔ:tə]n. 地下水
melted	adj.融化
liquid	n.液体
evaporation	n.蒸发
lubricate	vt.润滑
purified	adj.净化的
the pacific islands	[pəˈsifik] [ˈailənd]太平洋岛
topographical map	[mæp]n.地形图
bombardment	n.撞击
crater	n.火山坑，坑
crust	n.地壳外壳
mantle	n.地幔
atmospheric	a.大气的
dust	n.沙尘
ancient civilization	[ˌsivilaiˈzeiʃən] n.古文明
the Vikings	[ˈvaikiŋz]维京人
九大行星
Mercury	n. 水星
Venus	n. 金星
Earth	n. 地球
Mars	n. 火星
Jupiter	n. 木星
Saturn	n. 土星
Uranus	n. 天王星
Neptune	n. 海王星
Pluto	n.【已取消】冥王星
环境科学
气象学：
meteorology	气象
meteorologist	气象学家
meteorological	n.气象的
meteorological	station 气象站
climate	n.气候
forecast / predict 预报
ong-range forecast 长期预报
numerical	weather prediction 数值天气预报
temperature	n. 温度
degree Celsius	['selsiəs]adj.摄氏度
humid	a.潮湿的
moist	a.潮湿的；多雨的
hygrometer	a. 湿度计
thermometer	n.温度计；体温计
atmosphere 大气层
upper atmosphere n.上层大气
troposphere	对流层
stratosphere	平流层
mesosphere	中间层
ionosphere	电离层
wind n. 风
wind velocity	n.风速
breeze n. 微风
gale	n.大风
whirlwind	n.旋风
monsoon	n.季风
typhoon n.台风
hurricane n.飓风
tornado	/ twister ['twistə] /
cyclone	n.龙卷风
cold front n.冷锋
warm air massn.热气团
current（气）n.流
convection	n.对流
moisture n.潮湿，水气
vapor	n.蒸汽
evaporate	v.蒸发
spell n.某种天气持续一段时间
humidity	n.湿度
saturate	v.饱和
condense	v.浓缩
funnel	n.斗云
thunder	n.雷
precipitation	（雨、露、雪等）n. 降水
droplet	n.小水滴
sheet（水、冰、雪的）n.一层
shower n.阵雨
torrential	rain n.大雨
torrential l	rain n. 暴风雨
hail	n.冰雹
blizzard	/ snowstorm n.暴风雪
avalanche	/ snow slide n. 雪崩
fog / mist n.雾
frost	n.霜；冰冻
smog	n.烟雾
devastation	n.破坏
tidal	wave n.潮汐；浪潮
sandstorm	n. 沙暴
semiarid	adj. 半干旱
生态平衡（见生命科学生态学）：
recycle	vt. 循环
the carbon cycle	[ˈkɑ:bən] [ˈsaikəl]n.碳循环
nitrogen cycle	[ˈsaikəl]n.氮循环
phosphorus cycle	[ˈsaikəl]n.磷循环.
oceanography	n.海洋学
环境能源（见生命科学生态学）：
energy source 能源资源
nonrenewable	不可再生的
fossil oil	[ɔil] =petroleum [piˈtrəuliəm]n.石油
fossil fuel	n.（煤、石油、天然气等）矿物燃料
coal	n.煤
drain	v.（土地）排水，（资源等）逐渐枯竭
alternative energy sources	[ˈenədʒi] [sɔ:siz]n. 替代能源
solar energy 太阳能
tidal energy 潮汐能
energy conservation 保护能源
fuel-efficient 节能型的
environmental recycling center 再循环利用中心
dam	n.坝
reservoir	n.贮水池，水库
remote mountainous region	[ˈmauntinəs]
[ˈri:dʒən]n.偏远山区
环境污染（见自然科学环境学）：
circumstance	=
environment	n.环境
phenomena	n.现象（phenomenon [fiˈnɔmənən]的复数）
global warming 全球变暖
El Niño 厄尔尼诺现象
greenhouse effect	温室效应
	[oˈzonəˌsfɪr]臭氧层
burning of coal and oil 煤油燃烧
carbon dioxide release 二氧化碳排放
insulating effect	[iˈfekt]n.隔绝效果
offshore spillage	近海岸溢出
rise in sea level 海平面上升
desertification	沙漠化
deforest	滥伐森林
drought	干旱
pollution	=contaminate [kənˈtæmineit]vt.污染
acid rain	酸雨
deteriorate	恶化
	[ˈtɑksɪk]有毒的
soot	烟尘
purify	净化
litter	/trash[træʃ]/garbage['ɡɑrbɪdʒ]垃圾
waste disposal 废物处理
recycling	再循环
	[ˈwestˌwɔtɚ, -ˌwɑtɚ]污水
industrial sewage 工业污水
sewage disposal	污水处理
water shortage 水源缺乏
sewage purification	污水净化
off	-[ɔ(:)f]v.排水，径流
decompose	v. 分解
地理 Geography&地质 Geology
地理学：
equator	赤道
longitude	n.经度
latitude	n.纬度
height	/ [hait]n.海拔
altitude	高度
horizon	地平线
hemisphere	半球
continent	n.大陆，洲
	( [ˈəuʃən])n.大西洋
	( [ˈəuʃən])n.太平洋
polar region	[ˈri:dʒən]n.极地
Arctic	[pəul]/ [ˈɑ:ktik]n.北极
Antarctic	[pəul]/ [ænˈtɑ:ktik]n.南极
frigid zone	[zəun]n.寒带
temperate zone	n.温带
temperate latitudes 温带地区
tropical zone	n.热带
geographer	地理学家
terrestrial	地球的，陆地的
continental drift	[drift]大陆漂移说
continental shelf 大陆架
continental slope	[sləup]n. [海洋] 大陆坡
	地底下
topography	地形，地形学
ranges	山脉
	高地
lowland	低地
basin	盆地
depression 洼地，凹陷处；盆地
	洞穴
desert	n.沙漠
dune	n.沙丘
the Sahara Desert	n.撒哈拉沙漠
silt	n.沙，淤泥
dust	n.沙尘
flatland	,[ˈflætˌlænd, -lənd]平原
highland	= [ˈhailənd]n.高原
grassland	n.草原
tundra	n.苔原，冻原
rain forest	[ˈfɔrist]n.雨林
swamp	沼泽
peat bog	泥炭沼泽
valley	峡谷
Death Valley	[ˈvæli]n.（美）死谷
Grand Canyon	[ˈkænjən]n.（美）大峡谷
the Nile valley	[nail] [ˈvæli]n.尼罗河流域
Colorado river	科罗拉多河
lake	n.湖
	海峡
coastland 沿海地区
continental island	大陆岛
islet	小岛
peninsula	半岛
Arabian Peninsula	[piˈninsjulə]n.阿拉伯半岛
coral island	[ˈailənd]n.珊瑚岛
Empty Quarter	[ˈkwɔ:tə]n.阿拉伯半岛沙漠“空白之地”
tide	n.潮流；潮汐
monsoon rains	[reinz]n.季风雨
rainfall	n.降雨量
moisture	n.水分，湿度
hot spring 温泉
geyser	间歇喷泉
地质学：
geologist	n.地质学家
geologic feature	[ˈfi:tʃə]n.地质特征
crumples zones 地质缓冲地带
plate tectonics	[tek'tɔniks]n.板块构造论
dating technique	[tekˈni:k]n.年代测定技术
draw a diagram	[ei, ə, æn, ən][ˈdaiəgræm]v.画个图表
crust n.地壳
mantle	n.地幔
core n.地核
lithosphere	岩石圈
continental	crust 大陆地壳
oceanic	crust 海洋地壳
stratum	地层
stratigraphy	地层学
aquifer	蓄水层
fault plane 断层面
fault zone 断层带
rift / crack / split 断裂
cataclysm	灾变
undersea landslide 海底山崩
tsunami	/ tidal ['taɪdl] / force 海啸
drought	n.干旱
melt global warming 全球逐渐变暖
earthquake	n.地震
seismometer	n.地震仪；地震检波器
seismic	地震的
seismology	地震学
magnitude	震级
seismic intensity	scale 震烈度
seismic wave	地震波
transverse	wave 横波
epicenter	震中
epicentral	distance 震中距
glacier	n.冰川，冰河
Ice Age	[eidʒ]n.冰河世纪
glacial	冰川的
glacial epoch	/ age / period 冰川期
interglacial	adj.间冰期的
glacial drift 冰渍
moraines	冰碛
thaw	n.解冻，融雪
iceberg 冰山
volcano	n.火山
active volcano 活火山
extinct volcano	[vɔlˈkeinəu]n.死火山
dormant volcano 休眠火山
(sloping) shield volcano 盾状火山（平缓）
(steep-sided) cone volcano 锥状火山（陡峭）
eruption	火山喷发
magma	= lava [ˈlɑ:və] n.熔岩
volcanic dust 火山尘
volcanic ash 火山灰
terrestrial magnetism	n.地磁学；地
磁
magnetic force	[fɔ:s]n.磁力
terrestrial heat	n.地热
geothermal	adj.地热的
igneous	rock 火成岩
sedimentary	rock 沉积岩
metamorphic	rock 变质岩
granite	n.花岗岩
sandstone	n.砂岩
limestone	n.石灰岩
gypsum	n.石膏
particle	n.颗粒
ore	矿石
deposit	n.矿床
mineral 矿物
gem 宝石
diamond 钻石
ruby	红宝石
emerald	绿宝石
fossil	n.化石
marble	大理石
quartz	石英
crystal	n. 晶体
bedrock 岩床
formation	n.形成
water year	n.水文年
cycle	[ˈsaikəl]n.周期循环
voyage	n.航行；航程
expedition	n.探险
debris	n.残骸
erode	vt.腐蚀，侵蚀
soluble	a.可溶的，可溶解的
dissolves	v.溶解；分解
disintegration	/ decomposition[,di:k
ɔmpə'ziʃən]分解
drill	v.钻(孔)
化学 Chemistry
chemist	n.化学家
biochemistry	n.生物化学
inorganic chemistry	[ˈkemistri]n.无机
化学
constituent	n.成分
element	n. 元素；原理
the periodic table	[ˌpiəriˈɔdik] [ˈteibəl]n.元素周
期表
hydrogen	n.氢
carbon	n.碳
carbohydrate	n.碳水化合物
carbon dioxide	n.二氧化碳
nitrogen	n.氮
oxygen	n.氧
oxide	n.氧化物
silicon	n.硅
phosphorus	n.磷
sulfur	n.硫
sulfide	n.硫化物
calcium	钙
platinum	白金/铂金
silver	n.]银
copper	黄铜
iron	n.铁
rust	v.(使)生锈
aluminum	铝
tin	n.锡；罐头
lead	n.铅
zinc	n.锌
sodium	钠
nickel	镍
radioactive Uranium	[juəˈreinjəm]n.放射性铀
atom	原子
molecule	n.分子
nucleus	n.原子核
electron	n.电子
neutron	n.中子
proton	n.质子
proton number	n.质子数
atomic number	n.原子序数
cyclotron	n.粒子回旋加速器
radioactive Uranium	[juəˈreinjəm]n.放射性铀
ion	离子
isotope	n.同位素
decay	v.衰退；衰减
ore sample	[ˈsæmpl, ˈsɑ:mpəl]n.矿石样本
petroleum (oil)[pəˈtroliəm]石油
crude oil	原油
refine	提炼，精炼
gasoline	汽油
methane	甲烷
liquefy	v.溶化 | 液化
acid	n.酸
carbonic acid	[ˈæsid]n.碳酸
salinity	n.盐度
matter	=substances[ˈsʌbstənsiz]=material[məˈ tiəriəl]n.物质
derivative	衍生物
compound	n.化合物
synthesize	v.合成；综合
synthetic	adj.合成的
artificial	adj.人造的
polymerization	聚合作用
properties	n.特性
ingredient	n.材料
pigments	n.颜料；色素
dye	n.染料
plastic	adj.塑料的
cosmetics	n.化妆品
solution	n.溶液
dissolve	v.溶解
museum curator	[kjuəˈreitə]n.博物馆馆长
gap	n.缺口；空白
物理：Physics
physical science	n.物理科学
optics	光学
acoustics	声学
mechanics	力学，机械学
dynamics	动力学
aerodynamic	adj.气体动力的
hydrodynamics	n.流体力学
thermodynamics	热力学
optical	光（学）的
optic axis	n.光轴
dispersion	色散
lens	透镜，镜片
transparent	透明
translucent	半透明
opaque	不透明的
infrared microscope	[ˈmaikrəskəup]n.红外线显微镜
spectral signature	[ˈsignətʃə]n.光谱特征
wavelengths	n.波长
ray	X 光
frequency	n.频率
amplitude	n.振幅
intensity	n.强度
	媒质
echo	n.回声
resonance	n.共振；共鸣
force	n.力
inertia	n.惯性
velocity	n.速度
acceleration	n. 加速度
gravity	n.地心引力
acceleration of gravity	[əv] [ˈgræviti]n.重力
加速度
conversation of energy	[əv] [ˈenədʒi]n.能量守
恒
interaction	n.交互作用；感应
opposite	n.对立物
ratio	n.比, 比率
relativity	相对
test tube	n.试管
watt	n.瓦特
voltage	n.电压
electric charge	n.电荷
like charges	n. 同性电荷
pole	n.磁极，电极
negative	adj.负的
positive	adj.正的
	直流电
	交流电
electric circuit	电路
conduction	n.传导
conductor	n.导体
semiconductor	n.半导体
battery (cell)[ˈbætəri]n.电池
fluid	n.流体；液体
dilution	n.稀释
distillation	n.蒸馏
gasify	v.气化
test tube	n.试管
magnet	磁体
electromagnetism	电磁学
object	n.物体
mass	n.质量
liquid	n. 液体
solid	adj. 固体的；
fraction	n.小部分
fragment	n.碎片
property	n.性质
function	v.（机器、机制等）运行，发挥作用
waterproof	=watertight [ˈwɔ:tətaitnis] adj.防水
的
airborne	adj.（可以通过）空气传播的
transmit	v.传送，传导
magnetic force	[fɔ:s]n.磁力
rotation	n. 旋转；循环，轮流
vibration	n.振动
insulation	n.绝缘，绝热
Nobel Prize	[praiz] n. 贝尔奖
principle	n. 原理，原则；
equation	n. 等式；
其他高频词汇
code	n.法规
mission	n.任务
prospective	n. 预期；展望 adj.未来的； 预期的
|
emergence	n. 出现，
transition. n.转变/过渡
coincidence	n.巧合
peak	n.顶峰，最高值
consequence	n.后果，影响
controversy	n. 争论；论战；辩论
hostility	n.反对
interaction	n.相互作用
agent	n.媒介
withdrawal	n. & v.提取，收回
gap	n.缺口；空白
paradox	n. 悖论；似非而是的论点
explanatory	- [ˌekspləˈneiʃən]n.自我解释，不言自明
feature	n.特征
practical value	[ˈvælju:]n.实用价值
predict	v.预测
accompany	v.伴随
withstand	v.经受, 承受
prohibit	v.禁止
interrupt	v.中断
strengthen	vt.加强
diminish	v.减少
vary	v.不同，变化
deform	v.（使）变形
overlap	v.与……重叠
distinguish	v. 区别
be hostile to：对……有敌意
contradict	vt. 反驳；否定；与…矛盾；
convey	v.转达
discharge	vt.解雇；卸下；放出；
certify	v. 证明
identify	vt. 确定；认同；一致
affect	v.影响
venture	v.冒险
apply	v.应用
primarily	adv.主要地
widespread	adj.普遍的
associated	adj.关联的
elaborate	adj.精心制作的
precise	adj.精确的
logical	adj.合乎逻辑的
constant	adj. 恒久不变的
unique	adj. 独特的
uniform	adj.相同的
distorted	adj. 歪曲的；受到曲解的
authentic	adj.真正的，真实的；可信的
fierce	adj.猛烈的
sustainable	adj.可以忍受的
various	adj.不同的，好几个
futile	adj.无用的
in advance	adv.预先的
simultaneously	adv.同时地
gradually	adv. 逐步地
heretofore	adv.迄今为止
approximately	adv.大约
conversely	adv.相反地
